####################
S         ##########
######### ##########
######### ##########
######### ##########
#########       ####
#########E##########