####################
S         ##########
######### ##########
#########          #
######### ###### ###
#########        ###
#########E##########