####################
S         ##########
######### ##########
######### ##########
######### ##### ####
#########       ####
#########E##########